21
#    ##############    ################
##    ##############    ###############
####    ##############    #############
######    ##############    ###########
########    ##############    #########
##########    ##############    #######
############    ##############    #####
