28
      #       #       #       #
     ###     ###     ###     ###
    #####   #####   #####   #####
   ####### ####### ####### #######
    #####   #####   #####   #####
     ###     ###     ###     ###
      #       #       #       #
